    WWWWW          
    VFYFV          
    VPFFV          
  WWWFFPWW         
  VFFPFPFV         
WWWFWFWWFV   WWWWWW
VFFFWFWWFWWWWWFFFFV
VFPFFPFFFFFFFFFFECV
BBBBBFBBBFVFVVFFFFV
    VFFFFFBBBBBBBBB
    BBBBBBB        