WWWWWWWWWWWWWWWWWWWWWWWWWWWWWWWWWWWWWWWW
VFFFFFFFFFFFFFFFFFPFFFFFFFFFFFFFFFFFFYV 
VFFFWWWWWWWWWWFFWWWWWWWWWWWFFWFFWWWWWFV 
VFFFFFFFFFVFFFFFFFFFPFFFFFFFFVFCVFFFVFV 
VFFFWWWWFFVFFFWWWWWWWWWWWWWFFWWWWFFFVFV 
VFFFFVWFFPFFFFFFFFFFFFFFFFFFFFFFFFFFVFV 
VWWWFFVFFWWWWWWWWWWWWWWWWWWWWWWFFWWWWFV 
VFFFFFFPFFFFFFFFFFFFVFFFFFFFFFFFPFFFFFV 
VFFFWWWWWWWWWWWWWWWFVFWWWWWWWWWWWWFWWWV 
VFFFFFFFVFFFFFFFFFFFVFFFFFFFFPFFFFFFFFV 
VWWWWFFFVFFFWWWWWWWWWWWWWFFFWWWWWWWFFFV 
VFFFFFFFVFFFVFFFFFFFPFFFFFVFFFFFFFVFFFV 
VFWFWWWWWWWFFFWWWWWWWWWWWWWFFFVFFFVFFFV 
VFFFFFFFFFFFVFFFFFFFPFFFFFFFFFVFFFVFFFV 
VEFFWWWWWWWWWFWWWWWWWWWWWWWFFFWWWWWFFFV 
VFFFFFFFPFFFFFFFFFVFFFFFFFFFPFFFFFFFFFV 
VWWFFWWWWWWWWWWFFFVFFFVFFFWWWWWWWWWWWWV 
VWWFFFFFFFFFFFFFFFVFFFVFFFFFFFFFFFFFFFV 
VFFPPPPPPPPPPPPPPPPPPPPPPPPPPPPPPPFFFV  
BBBBBBBBBBBBBBBBBBBBBBBBBBBBBBBBBBBBBBBB